Actinopterygii	Chordata
Agaricomycetes	Basidiomycota
Amborellales	Streptophyta
Amphibia	Chordata
Anthozoa	Cnidaria
Appendicularia	Chordata
Arachnida	Arthropoda
Ascidiacea	Chordata
Asteroidea	Echinodermata
Aves	Chordata
Bdelloidea	Rotifera
Bivalvia	Mollusca
Branchiopoda	Arthropoda
Cestoda	Platyhelminthes
Chilopoda	Arthropoda
Chlorophyceae	Chlorophyta
Chondrichthyes	Chordata
Chromadorea	Nematoda
Clitellata	Annelida
Demospongiae	Porifera
Dothideomycetes	Ascomycota
Echinoidea	Echinodermata
Enoplea	Nematoda
Enteropneusta	Hemichordata
Eurotiomycetes	Ascomycota
Gastropoda	Mollusca
Hydrozoa	Cnidaria
Hyperoartia	Chordata
Insecta	Arthropoda
Klebsormidiophyceae	Streptophyta
Leotiomycetes	Ascomycota
Leptocardii	Chordata
Liliopsida	Streptophyta
Magnoliopsida	Streptophyta
Malacostraca	Arthropoda
Malasseziomycetes	Basidiomycota
Mammalia	Chordata
Maxillopoda	Arthropoda
Monogenea	Platyhelminthes
Mucoromycota	Mucoromycota
Orbiliomycetes	Ascomycota
Pezizomycetes	Ascomycota
Pinopsida	Streptophyta
Polychaeta	Annelida
Priapulida	Priapulida
Pucciniomycetes	Basidiomycota
Reptilia	Chordata
Saccharomycetes	Ascomycota
Sarcopterygii	Chordata
Sordariomycetes	Ascomycota
Taphrinomycetes	Ascomycota
Tentaculata	Ctenophora
Trematoda	Platyhelminthes
Tremellomycetes	Basidiomycota
Urediniomycetes	Basidiomycota
Ustilaginomycetes	Basidiomycota
Xiphosura	Arthropoda
