Acariformes	Arachnida
Accipitriformes	Aves
Actiniaria	Anthozoa
Afrotheria	Mammalia
Agaricales	Agaricomycetes
Alismatales	Liliopsida
Amborellales	Amborellales
Amphioxiformes	Leptocardii
Amphipoda	Malacostraca
Anguilliformes	Actinopterygii
Anseriformes	Aves
Anthoathecata	Hydrozoa
Anura	Amphibia
Apodiformes	Aves
Araneae	Arachnida
Arecales	Liliopsida
Ascaridida	Chromadorea
Asterales	Magnoliopsida
Auriculariales	Agaricomycetes
Bdelloidea	Bdelloidea
Beloniformes	Actinopterygii
Blattodea	Insecta
Boletales	Agaricomycetes
Brassicales	Magnoliopsida
Calanoida	Maxillopoda
Capitellida	Polychaeta
Caprimulgiformes	Aves
Carcharhiniformes	Chondrichthyes
Carnivora	Mammalia
Caryophyllales	Magnoliopsida
Cetartiodactyla	Mammalia
Chaetothyriales	Eurotiomycetes
Characiformes	Actinopterygii
Chimaeriformes	Chondrichthyes
Chiroptera	Mammalia
Chlamydomonadales	Chlorophyceae
Chlorococcales	Chlorophyceae
Coelacanthiformes	Sarcopterygii
Coleoptera	Insecta
Copelata	Appendicularia
Corticiales	Agaricomycetes
Crocodilia	Reptilia
Cuculiformes	Aves
Cucurbitales	Magnoliopsida
Cyclophyllidea	Cestoda
Cypriniformes	Actinopterygii
Cyprinodontiformes	Actinopterygii
Diplostraca	Branchiopoda
Diptera	Insecta
Echinoida	Echinoidea
Enterogona	Ascidiacea
Enteropneusta	Enteropneusta
Ephemeroptera	Insecta
Ericales	Magnoliopsida
Eurotiales	Eurotiomycetes
Euthyneura	Gastropoda
Fabales	Magnoliopsida
Fagales	Magnoliopsida
Gadiformes	Actinopterygii
Galliformes	Aves
Gastropoda	Gastropoda
Gaviiformes	Aves
Geophilomorpha	Chilopoda
Gloeophyllales	Agaricomycetes
Glomerellales	Sordariomycetes
Gruiformes	Aves
Haplosclerida	Demospongiae
Hemiptera	Insecta
Homoptera	Insecta
Hymenoptera	Insecta
Hypocreales	Sordariomycetes
Insectivora	Mammalia
Isoptera	Insecta
Ixodida	Arachnida
Klebsormidiales	Klebsormidiophyceae
Lagomorpha	Mammalia
Lamiales	Magnoliopsida
Leotiomycetes	Leotiomycetes
Lepidoptera	Insecta
Lepisosteiformes	Actinopterygii
Leptosomiformes	Aves
Lobata	Tentaculata
Malasseziales	Malasseziomycetes
Malpighiales	Magnoliopsida
Malvales	Magnoliopsida
Marsupialia	Mammalia
Mengenillidia	Insecta
Mesostigmata	Arachnida
Mortierellales	Mucoromycota
Mucorales	Mucoromycota
Musophagiformes	Aves
Myrtales	Magnoliopsida
Odonata	Insecta
Onygenales	Eurotiomycetes
Opisthocomiformes	Aves
Orbiliales	Orbiliomycetes
Orthoptera	Insecta
Ostreoida	Bivalvia
Parasitiformes	Arachnida
Passeriformes	Aves
Pelecaniformes	Aves
Perciformes	Actinopterygii
Perissodactyla	Mammalia
Petromyzontiformes	Hyperoartia
Pezizales	Pezizomycetes
Pholidota	Mammalia
Phthiraptera	Insecta
Piciformes	Aves
Pinales	Pinopsida
Plagiorchiida	Trematoda
Pleosporales	Dothideomycetes
Pleurogona	Ascidiacea
Pleuronectiformes	Actinopterygii
Poales	Magnoliopsida
Polyporales	Agaricomycetes
Priapulida	Priapulida
Primates	Mammalia
Proteales	Magnoliopsida
Protopolystoma	Monogenea
Psittaciformes	Aves
Rhabditida	Chromadorea
Rhynchobdellida	Clitellata
Rodentia	Mammalia
Rosales	Magnoliopsida
Russulales	Agaricomycetes
Saccharomycetales	Saccharomycetes
Sapindales	Magnoliopsida
Sarcoptiformes	Arachnida
Scandentia	Mammalia
Scorpiones	Arachnida
Siphonostomatoida	Maxillopoda
Solanales	Magnoliopsida
Sphaeriales	Sordariomycetes
Sphenisciformes	Aves
Sporidiales	Urediniomycetes
Squamata	Reptilia
Strigeidida	Trematoda
Strongylida	Chromadorea
Strongyloidoidea	Chromadorea
Struthioniformes	Aves
Taphrinales	Taphrinomycetes
Temnopleuroida	Echinoidea
Testudines	Reptilia
Tetraodontiformes	Actinopterygii
Thysanoptera	Insecta
Tremellales	Tremellomycetes
Trichocephalida	Enoplea
Trichoptera	Insecta
Trogoniformes	Aves
Trombidiformes	Arachnida
Uredinales	Pucciniomycetes
Ustilaginales	Ustilaginomycetes
Valvatida	Asteroidea
Vitales	Magnoliopsida
Xenarthra	Mammalia
Xiphosura	Xiphosura
Zingiberales	Liliopsida
Monotreme	Mammalia
