Achipteria.coleoptrata	Sarcoptiformes
Acromyrmex.echinatior	Hymenoptera
Actinidia.chinensis	Ericales
Acyrthosiphon.pisum	Homoptera
Adineta.vaga	Bdelloidea
Aedes.aegypti	Diptera
Aegilops.tauschii	Poales
Aethionema.arabicum	Brassicales
Agaricus.bisporus.var.bisporus	Agaricales
Agaricus.bisporus.var.burnettii	Agaricales
Agrilus.planipennis	Coleoptera
Ailuropoda.melanoleuca	Carnivora
Alligator.mississippiensis	Crocodilia
Alligator.sinensis	Crocodilia
Amaranthus.hypochondriacus	Caryophyllales
Amaranthus.tuberculatus	Caryophyllales
Amborella.trichopoda	Amborellales
Amphimedon.queenslandica	Haplosclerida
Anas.platyrhynchos	Anseriformes
Anguilla.anguilla	Anguilliformes
Anguilla.japonica	Anguilliformes
Anolis.carolinensis	Squamata
Anopheles.albimanus	Diptera
Anopheles.arabiensis	Diptera
Anopheles.atroparvus	Diptera
Anopheles.christyi	Diptera
Anopheles.culicifacies	Diptera
Anopheles.darlingi	Diptera
Anopheles.dirus	Diptera
Anopheles.epiroticus	Diptera
Anopheles.farauti	Diptera
Anopheles.funestus	Diptera
Anopheles.gambiae	Diptera
Anopheles.maculatus	Diptera
Anopheles.melas	Diptera
Anopheles.merus	Diptera
Anopheles.minimus	Diptera
Anopheles.quadriannulatus	Diptera
Anopheles.sinensis	Diptera
Anopheles.stephensi	Diptera
Anoplophora.glabripennis	Coleoptera
Apaloderma.vittatum	Trogoniformes
Apalone.spinifera	Testudines
Apis.dorsata	Hymenoptera
Apis.florea	Hymenoptera
Apis.mellifera	Hymenoptera
Aplysia.californica	Euthyneura
Aptenodytes.forsteri	Sphenisciformes
Aquila.chrysaetos	Accipitriformes
Aquilaria.agallochum	Malvales
Arabidopsis.halleri	Brassicales
Arabidopsis.lyrata	Brassicales
Arabidopsis.thaliana	Brassicales
Arabis.alpina	Brassicales
Ascaris.suum	Ascaridida
Aspergillus.fischeri	Eurotiales
Aspergillus.flavus	Eurotiales
Astyanax.mexicanus	Characiformes
Athalia.rosae	Hymenoptera
Atta.cephalotes	Hymenoptera
Auricularia.subglabra	Auriculariales
Azadirachta.indica	Sapindales
Balaenoptera.acutorostrata	Cetartiodactyla
Balearica.regulorum	Gruiformes
Beauveria.bassiana	Hypocreales
Beta.vulgaris	Caryophyllales
Betula.nana	Fagales
Biomphalaria.glabrata	Gastropoda
Bipolaris.oryzae	Pleosporales
Bison.bison	Cetartiodactyla
Blattella.germanica	Blattodea
Bombus.impatiens	Hymenoptera
Bombus.terrestris	Hymenoptera
Bombyx.mori	Lepidoptera
Bos.indicus	Cetartiodactyla
Bos.mutus	Cetartiodactyla
Bos.taurus	Cetartiodactyla
Botryllus.schlosseri	Pleurogona
Branchiostoma.floridae	Amphioxiformes
Brassica.napus	Brassicales
Brassica.oleracea	Brassicales
Brassica.rapa	Brassicales
Bubalus.bubalis	Cetartiodactyla
Caenorhabditis.11	Rhabditida
Caenorhabditis.angaria	Rhabditida
Caenorhabditis.brenneri	Rhabditida
Caenorhabditis.briggsae	Rhabditida
Caenorhabditis.elegans	Rhabditida
Caenorhabditis.japonica	Rhabditida
Cajanus.cajan	Fabales
Callithrix.jacchus	Primates
Callorhinchus.milii	Chimaeriformes
Camelina.sativa	Brassicales
Camelus.dromedarius	Cetartiodactyla
Camelus.ferus	Cetartiodactyla
Camponotus.floridanus	Hymenoptera
Candida.albicans	Saccharomycetales
Candida.auris	Saccharomycetales
Candida.dubliniensis	Saccharomycetales
Candida.tanzawaensis	Saccharomycetales
Canis.lupus	Carnivora
Cannabis.sativa	Rosales
Capitella.teleta	Capitellida
Capra.hircus	Cetartiodactyla
Caprimulgus.carolinensis	Caprimulgiformes
Capronia.epimyces	Chaetothyriales
Capsella.rubella	Brassicales
Capsicum.annuum	Solanales
Carcharhinus.brachyurus	Carcharhiniformes
Carica.papaya	Brassicales
Castanea.mollissima	Fagales
Cathartes.aura	Accipitriformes
Cavia.aperea	Rodentia
Cavia.porcellus	Rodentia
Centruroides.exilicauda	Scorpiones
Cephus.cinctus	Hymenoptera
Cerapachys.biroi	Hymenoptera
Ceratitis.capitata	Diptera
Ceratosolen.solmsi	Hymenoptera
Ceratotherium.simum	Perissodactyla
Chaetura.pelagica	Apodiformes
Chelonia.mydas	Testudines
Chinchilla.lanigera	Rodentia
Chlamydomonas.reinhardtii	Chlamydomonadales
Chlorocebus.sabaeus	Primates
Choloepus.hoffmanni	Xenarthra
Chrysemys.picta	Testudines
Chrysochloris.asiatica	Afrotheria
Cicer.arietinum	Fabales
Cimex.lectularius	Hemiptera
Ciona.intestinalis	Enterogona
Ciona.savignyi	Enterogona
Citrullus.lanatus	Cucurbitales
Citrus.clementine	Sapindales
Citrus.sinensis	Sapindales
Clonorchis.sinensis	Plagiorchiida
Coccidioides.immitis	Onygenales
Coccomyxa.subellipsoidea	Chlorococcales
Colinus.virginianus	Galliformes
Colletotrichum.gloeosporioides	Glomerellales
Colletotrichum.higginsianum	Glomerellales
Colletotrichum.orchidophilum	Glomerellales
Condylura.cristata	Insectivora
Coniophora.puteana	Boletales
Conyza.canadensis	Asterales
Copidosoma.floridanum	Hymenoptera
Coprinopsis.cinerea	Agaricales
Corvus.brachyrhynchos	Passeriformes
Corvus.cornix	Passeriformes
Crassostrea.gigas	Ostreoida
Cricetulus.griseus	Rodentia
Crocodylus.porosus	Crocodilia
Crotalus.mitchellii	Squamata
Cuculus.canorus	Cuculiformes
Cucumis.melo	Cucurbitales
Cucumis.sativus	Cucurbitales
Culex.quinquefasciatus	Diptera
Cynoglossus.semilaevis	Pleuronectiformes
Dactylellina.haptotyla	Orbiliales
Danaus.plexippus	Lepidoptera
Danio.rerio	Cypriniformes
Daphnia.pulex	Diplostraca
Dasypus.novemcinctus	Xenarthra
Dendroctonus.ponderosae	Coleoptera
Dermatophagoides.farinae	Acariformes
Dianthus.caryophyllus	Caryophyllales
Diaphorina.citri	Hemiptera
Dichomitus.squalens	Polyporales
Diospyros.lotus	Ericales
Dipodomys.ordii	Rodentia
Drosophila.albomicans	Diptera
Drosophila.ananassae	Diptera
Drosophila.biarmipes	Diptera
Drosophila.bipectinata	Diptera
Drosophila.elegans	Diptera
Drosophila.erecta	Diptera
Drosophila.eugracilis	Diptera
Drosophila.ficusphila	Diptera
Drosophila.grimshawi	Diptera
Drosophila.kikkawai	Diptera
Drosophila.melanogaster	Diptera
Drosophila.miranda	Diptera
Drosophila.mojavensis	Diptera
Drosophila.persimilis	Diptera
Drosophila.pseudoobscura	Diptera
Drosophila.rhopaloa	Diptera
Drosophila.sechellia	Diptera
Drosophila.suzukii	Diptera
Drosophila.takahashii	Diptera
Drosophila.virilis	Diptera
Drosophila.willistoni	Diptera
Drosophila.yakuba	Diptera
Echinococcus.granulosus	Cyclophyllidea
Echinops.telfairi	Afrotheria
Egretta.garzetta	Pelecaniformes
Eidolon.helvum	Chiroptera
Elaeis.oleifera	Arecales
Elephantulus.edwardii	Afrotheria
Ensete.ventricosum	Zingiberales
Ephemera.danica	Ephemeroptera
Eptesicus.fuscus	Chiroptera
Equus.caballus.Mongolian	Perissodactyla
Equus.caballus.Thoroughbred	Perissodactyla
Equus.przewalskii	Perissodactyla
Erinaceus.europaeus	Insectivora
Eucalyptus.camaldulensis	Myrtales
Eucalyptus.grandis	Myrtales
Eurytemora.affinis	Calanoida
Eutrema.parvulum	Brassicales
Eutrema.salsugineum	Brassicales
Felis.catus	Carnivora
Ficedula.albicollis	Passeriformes
Fonsecaea.nubica	Chaetothyriales
Fragaria.ananassa	Rosales
Fragaria.iinumae	Rosales
Fragaria.nubicola	Rosales
Fragaria.orientalis	Rosales
Fragaria.vesca	Rosales
Frankliniella.occidentalis	Thysanoptera
Fraxinus.excelsior	Lamiales
Fukomys.damarensis	Rodentia
Fundulus.heteroclitus	Cyprinodontiformes
Fusarium.oxysporum	Hypocreales
Fusarium.verticillioides	Hypocreales
Gadus.morhua	Gadiformes
Galeopterus.variegatus	Primates
Gallus.gallus	Galliformes
Gasterosteus.aculeatus	Perciformes
Gavia.stellata	Gaviiformes
Gavialis.gangeticus	Crocodilia
Genlisea.aurea	Lamiales
Gloeophyllum.trabeum	Gloeophyllales
Glossina.austeni	Diptera
Glossina.brevipalpis	Diptera
Glossina.fuscipes	Diptera
Glossina.morsitans	Diptera
Glossina.pallidipes	Diptera
Glycine.soja	Fabales
Gorilla.gorilla	Primates
Gossypium.arboreum	Malvales
Gossypium.raimondii	Malvales
Haemonchus.contortus	Strongylida
Haliaeetus.albicilla	Accipitriformes
Haliaeetus.leucocephalus	Accipitriformes
Haplochromis.burtoni	Perciformes
Harpegnathos.saltator	Hymenoptera
Heliconius.melpomene	Lepidoptera
Helobdella.robusta	Rhynchobdellida
Heterobasidion.irregulare	Russulales
Heterocephalus.glaber	Rodentia
Histoplasma.capsulatum	Onygenales
Homo.sapiens	Primates
Hyalella.azteca	Amphipoda
Hydra.vulgaris	Anthoathecata
Hymenolepis.microstoma	Cyclophyllidea
Hypochthonius.rufulus	Sarcoptiformes
Ictidomys.tridecemlineatus	Rodentia
Ixodes.ricinus	Ixodida
Ixodes.scapularis	Ixodida
Jaculus.jaculus	Rodentia
Jatropha.curcas	Malpighiales
Klebsormidium.flaccidum	Klebsormidiales
Laccaria.bicolor	Agaricales
Ladona.fulva	Odonata
Lagenaria.siceraria	Cucurbitales
Latimeria.chalumnae	Coelacanthiformes
Latrodectus.hesperus	Araneae
Leavenworthia.alabamica	Brassicales
Leersia.perrieri	Poales
Lepeophtheirus.salmonis	Siphonostomatoida
Lepisosteus.oculatus	Lepisosteiformes
Leptinotarsa.decemlineata	Coleoptera
Leptonychotes.weddellii	Carnivora
Leptosomus.discolour	Leptosomiformes
Lethenteron.camtschaticum	Petromyzontiformes
Limnephilus.lunatus	Trichoptera
Limulus.polyphemus	Xiphosura
Linepithema.humile	Hymenoptera
Linum.usitatissimum	Malpighiales
Lipotes.vexillifer	Cetartiodactyla
Lobosporangium.transversale	Mortierellales
Locusta.migratoria	Orthoptera
Lottia.gigantea	Gastropoda
Lotus.japonicus	Fabales
Loxodonta.africana	Afrotheria
Lupinus.angustifolius	Fabales
Lutzomyia.longipalpis	Diptera
Lytechinus.variegatus	Temnopleuroida
Macaca.fascicularis	Primates
Macaca.mulatta	Primates
Macropus.eugenii	Marsupialia
Malassezia.sympodialis	Malasseziales
Malus.domestica	Rosales
Manduca.sexta	Lepidoptera
Manihot.esculenta	Malpighiales
Manis.pentadactyla	Pholidota
Mayetiola.destructor	Diptera
Maylandia.zebra	Perciformes
Medicago.truncatula	Fabales
Megachile.rotundata	Hymenoptera
Megaderma.lyra	Chiroptera
Melampsora.larici-populina	Uredinales
Melitaea.cinxia	Lepidoptera
Melopsittacus.undulatus	Psittaciformes
Mengenilla.moldrzyki	Mengenillidia
Mesobuthus.martensii	Scorpiones
Mesocricetus.auratus	Rodentia
Metaseiulus.occidentalis	Mesostigmata
Metschnikowia.bicuspidata	Saccharomycetales
Microcebus.murinus	Primates
Microplitis.demolitor	Hymenoptera
Microtus.ochrogaster	Rodentia
Mimulus.guttatus	Lamiales
Mnemiopsis.leidyi	Lobata
Moesziomyces.antarcticus	Ustilaginales
Moniliophthora.roreri	Agaricales
Monodelphis.domestica	Marsupialia
Morus.notabilis	Rosales
Mus.musculus	Rodentia
Musa.acuminata	Zingiberales
Musca.domestica	Diptera
Mustela.putorius	Carnivora
Myotis.brandtii	Chiroptera
Myotis.davidii	Chiroptera
Myotis.lucifugus	Chiroptera
Nannospalax.galili	Rodentia
Nanorana.parkeri	Anura
Nasalis.larvatus	Primates
Nasonia.giraulti	Hymenoptera
Nasonia.longicornis	Hymenoptera
Nasonia.vitripennis	Hymenoptera
Necator.americanus	Strongylida
Nelumbo.nucifera	Proteales
Nematostella.vectensis	Actiniaria
Neolamprologus.brichardi	Perciformes
Nicotiana.sylvestris	Solanales
Nicotiana.tomentosiformis	Solanales
Nilaparvata.lugens	Hemiptera
Nipponia.nippon	Pelecaniformes
Nomascus.leucogenys	Primates
Ochotona.princeps	Lagomorpha
Octodon.degus	Rodentia
Odobenus.rosmarus	Carnivora
Oikopleura.dioica	Copelata
Oncopeltus.fasciatus	Hemiptera
Onthophagus.taurus	Coleoptera
Ophiophagus.hannah	Squamata
Opisthocomus.hoazin	Opisthocomiformes
Orcinus.orca	Cetartiodactyla
Oreochromis.niloticus	Perciformes
Orussus.abietinus	Hymenoptera
Orycteropus.afer	Afrotheria
Oryctolagus.cuniculus	Lagomorpha
Oryza.barthii	Poales
Oryza.brachyantha	Poales
Oryza.glumipatula	Poales
Oryza.longistaminata	Poales
Oryza.meridionalis	Poales
Oryza.nivara	Poales
Oryza.punctata	Poales
Oryza.sativa	Poales
Oryzias.latipes	Beloniformes
Otolemur.garnettii	Primates
Ovis.aries.Texel	Cetartiodactyla
Ovis.aries.musimon	Cetartiodactyla
Pachypsylla.venusta	Hemiptera
Pan.paniscus	Primates
Pan.troglodytes	Primates
Panagrellus.redivivus	Rhabditida
Panthera.tigris	Carnivora
Pantholops.hodgsonii	Cetartiodactyla
Papilio.glaucus	Lepidoptera
Papilio.polytes	Lepidoptera
Papilio.xuthus	Lepidoptera
Papio.anubis	Primates
Parastagonospora.nodorum	Pleosporales
Parasteatoda.tepidariorum	Araneae
Patiria.miniata	Valvatida
Pediculus.humanus	Phthiraptera
Pelecanus.crispus	Pelecaniformes
Pelodiscus.sinensis	Testudines
Penstemon.centranthifolius	Lamiales
Penstemon.grinnellii	Lamiales
Peromyscus.maniculatus	Rodentia
Petromyzon.marinus	Petromyzontiformes
Phaethon.lepturus	Pelecaniformes
Phalacrocorax.carbo	Pelecaniformes
Phanerochaete.carnosa	Polyporales
Phaseolus.vulgaris	Fabales
Phlebotomus.papatasi	Diptera
Phoenix.dactylifera	Arecales
Phycomyces.blakesleeanus	Mucorales
Physeter.catodon	Cetartiodactyla
Picoides.pubescens	Piciformes
Pinus.taeda	Pinales
Platynothrus.peltifer	Sarcoptiformes
Plutella.xylostella	Lepidoptera
Poecilia.formosa	Cyprinodontiformes
Pogona.vitticeps	Squamata
Pogonomyrmex.barbatus	Hymenoptera
Pongo.abelii	Primates
Populus.euphratica	Malpighiales
Populus.trichocarpa	Malpighiales
Postia.placenta	Polyporales
Priapulus.caudatus	Priapulida
Primula.veris	Ericales
Procavia.capensis	Afrotheria
Protopolystoma.xenopodis	Protopolystoma
Prunus.mume	Rosales
Prunus.persica	Rosales
Pseudogymnoascus.destructans	Leotiomycetes
Pseudopodoces.humilis	Passeriformes
Pteronotus.parnellii	Chiroptera
Pteropus.alecto	Chiroptera
Pteropus.vampyrus	Chiroptera
Punctularia.strigosozonata	Corticiales
Pundamilia.nyererei	Perciformes
Pygoscelis.adeliae	Sphenisciformes
Pyrus.bretschneideri	Rosales
Python.bivittatus	Squamata
Raphanus.raphanistrum	Brassicales
Raphanus.sativus	Brassicales
Rattus.norvegicus	Rodentia
Rhinolophus.ferrumequinum	Chiroptera
Rhinopithecus.roxellana	Primates
Rhipicephalus.microplus	Ixodida
Rhizopus.microsporus	Mucorales
Rhodnius.prolixus	Hemiptera
Rhodotorula.toruloides	Sporidiales
Ricinus.communis	Malpighiales
Saccoglossus.kowalevskii	Enteropneusta
Saimiri.boliviensis	Primates
Saitoella.complicata	Taphrinales
Sarcophilus.harrisii	Marsupialia
Sarcoptes.scabiei	Sarcoptiformes
Scheffersomyces.stipitis	Saccharomycetales
Schistosoma.curassoni	Strigeidida
Schistosoma.haematobium	Strigeidida
Schistosoma.japonicum	Strigeidida
Schistosoma.mansoni	Strigeidida
Schistosoma.margrebowiei	Strigeidida
Schistosoma.mattheei	Strigeidida
Schistosoma.rodhaini	Strigeidida
Schizophyllum.commune	Agaricales
Sebastes.nigrocinctus	Perciformes
Sebastes.rubrivinctus	Perciformes
Serinus.canaria	Passeriformes
Sesamum.indicum	Lamiales
Setaria.italica	Poales
Sisymbrium.irio	Brassicales
Solanum.arcanum	Solanales
Solanum.habrochaites	Solanales
Solanum.lycopersicum	Solanales
Solanum.melongena	Solanales
Solanum.pennellii	Solanales
Solanum.pimpinellifolium	Solanales
Solanum.tuberosum	Solanales
Solenopsis.invicta	Hymenoptera
Sordaria.macrospora	Sphaeriales
Sorex.araneus	Insectivora
Sorghum.bicolor	Poales
Spinacia.oleracea	Caryophyllales
Spirodela.polyrhiza	Alismatales
Steganacarus.magnus	Sarcoptiformes
Stegodyphus.mimosarum	Araneae
Steinernema.monticolum	Strongyloidoidea
Stereum.hirsutum	Russulales
Strigamia.maritima	Geophilomorpha
Strongylocentrotus.purpuratus	Echinoida
Struthio.camelus	Struthioniformes
Sus.scrofa.Duroc	Cetartiodactyla
Sus.scrofa.Minipig	Cetartiodactyla
Sus.scrofa.Tibetan	Cetartiodactyla
Taeniopygia.guttata	Passeriformes
Takifugu.flavidus	Tetraodontiformes
Takifugu.rubripes	Tetraodontiformes
Talaromyces.atroroseus	Eurotiales
Talaromyces.stipitatus	Eurotiales
Tarenaya.hassleriana	Brassicales
Tarsius.syrichta	Primates
Tauraco.erythrolophus	Musophagiformes
Tetranychus.urticae	Trombidiformes
Tetraodon.nigroviridis	Tetraodontiformes
Theobroma.cacao	Malvales
Trametes.versicolor	Polyporales
Tremella.mesenterica	Tremellales
Tribolium.castaneum	Coleoptera
Trichechus.manatus	Afrotheria
Trichinella.spiralis	Trichocephalida
Trichogramma.pretiosum	Hymenoptera
Trifolium.pratense	Fabales
Triticum.urartu	Poales
Tuber.melanosporum	Pezizales
Tupaia.belangeri	Scandentia
Tupaia.chinensis	Scandentia
Tursiops.truncatus	Cetartiodactyla
Uncinocarpus.reesii	Onygenales
Ursus.maritimus	Carnivora
Ustilago.maydis	Ustilaginales
Vaccinium.macrocarpon	Ericales
Varroa.destructor	Parasitiformes
Vicugna.pacos	Cetartiodactyla
Vigna.radiata	Fabales
Vipera.berus	Squamata
Vitis.vinifera	Vitales
Wickerhamomyces.anomalus	Saccharomycetales
Wickerhamomyces.ciferrii	Saccharomycetales
Xenopus.laevis	Anura
Xenopus.tropicalis	Anura
Xiphophorus.maculatus	Cyprinodontiformes
Yarrowia.lipolytica	Saccharomycetales
Zea.mays	Poales
Zizania.latifolia	Poales
Zootermopsis.nevadensis	Isoptera
Tachyglossus.aculeatus	Monotreme
Ornithorhynchus.anatinus	Monotreme
